. . . . . . . . . . . . . . . . . . . . . . . . . . . .
. . . . . . . . . . . . . . . . . . . . . . . . . . . .
. . . . . . . . . . . . . . . . . . . . . . . . . . . .
. . . . . . . . . . . . . . . . . . . . . . . . . . . .
. . . . . . . . . . . . . . . . . . . . . . . . . . . . 
. . . . . . . . . . . . . . . . . . . . . . . . . . . .
. . . . . . . . . . . . . . . . . . . . . . . . . . . .
. . . . . . . . . . . . . . . . . . . . . . . . . . . .
. + - - - - - - - + - - - - - - H - - - - - - - + . . .
. | . . . . . . . | . . . . . . | . . . . . . . | . . .
. | . . . . . . . | . . . . . . | . . . . . . . | . . .
. | . . . . . . . | . . . . . . F . . . . . . . | . . .
. | . . . . . . . | . . . . . . | . . . . . . . | . . .
. | . . . . . . . | . . . . . . | . . . . . . . | . . .
. + - - - - - - - + - - P - - - + - - - - - - - + . . .
. . . . . . . . . . . . . . . . . . . . . . . . . . . .
. . . . . . . . . . . . . . . . . . . . . . . . . . . .
. . . . . . . . . . . . . . . . . . . . . . . . . . . .
. . . . . . . . . . . . . . . . . . . . . . . . . . . .
. . . . . . . . . . . . . . . . . . . . . . . . . . . .
. . . . . . . . . . . . . . . . . . . . . . . . . . . .
. . . . . . . . . . . . . . . . . . . . . . . . . . . .
